grek	latn
α	a
ά	á
Α	A
Ά	Á
β	v
Β	V
γ	g
Γ	G
δ	d
Δ	D
ε	e
έ	é
Ε	E
Έ	É
ζ	z
Ζ	Z
η	i
ή	í
Η	I
Ή	Í
θ	th
Θ	Th
ι	i
ί	í
ϊ	ï
ΐ	í̈
Ι	I
Ί	Í
Ϊ	Ï
κ	k
Κ	K
λ	l
Λ	L
μ	m
Μ	M
ν	n
Ν	N
ξ	x
Ξ	X
ο	o
ό	ó
Ο	O
Ό	Ó
π	p
Π	P
ρ	r
Ρ	R
ς	s
σ	s
Σ	S
τ	t
Τ	T
υ	y
ύ	ý
ϋ	ÿ
ΰ	ý̈
Υ	Y
Ύ	Ý
Ϋ	Ÿ
φ	f
Φ	F
χ	ch
Χ	Ch
ψ	ps
Ψ	Ps
ω	o
ώ	ó
Ω	O
Ώ	Ó
