grek	latn
α	a
ά	á
β	b
γ	g
δ	d
ε	e
έ	é
ζ	z
η	e
ή	é
θ	th
ι	i
ί	í
ϊ	ï
ΐ	í̈
κ	k
λ	l
μ	m
ν	n
ξ	x
ο	o
ό	ó
π	p
ρ	r
ς	s
σ	s
τ	t
υ	y
ύ	ý
ϋ	ÿ
ΰ	ý̈
φ	ph
χ	ch
ψ	ps
ω	o
ώ	ó
Α	A
Ά	Á
Β	B
Γ	G
Δ	D
Ε	E
Έ	É
Ζ	Z
Η	E
Ή	É
Θ	Th
Ι	I
Ί	Í
Ϊ	Ï
Κ	K
Λ	L
Μ	M
Ν	N
Ξ	X
Ο	O
Ό	Ó
Π	P
Ρ	R
Σ	S
Τ	T
Υ	Y
Ύ	Ý
Ϋ	Ÿ
Φ	Ph
Χ	Ch
Ψ	Ps
Ω	O
Ώ	Ó
