grek	latn
α	a
Α	A
β	b
Β	B
γ	g
Γ	G
δ	d
Δ	D
ε	e
Ε	E
ζ	z
Ζ	Z
η	ē
Η	Ē
θ	th
Θ	Th
ι	i
Ι	I
κ	k
Κ	K
λ	l
Λ	L
μ	m
Μ	M
ν	n
Ν	N
ξ	x
Ξ	X
ο	o
Ο	O
π	p
Π	P
ρ	r
Ρ	R
ς	s
σ	s
Σ	S
τ	t
Τ	T
υ	y
Υ	Y
φ	ph
Φ	Ph
χ	ch
Χ	Ch
ψ	ps
Ψ	Ps
ω	ō
Ω	Ō
·	;
;	?
΄	´
̃	̂
̑	̂
